51 50 70 
10 3 0 0 0 0 4 0 0 0 0 1 1 0 0 0 0 0 0 0 0 0 0 0 5 1 1 5 0 5 1 2 5 0 0 0 0 0 0 0 0 1 0 0 0 0 1 0 0 0 
10 1 0 0 0 0 5 0 0 0 0 1 0 0 0 0 0 0 0 0 0 0 0 0 0 5 1 1 1 1 1 5 5 0 0 0 0 0 0 0 1 1 0 0 0 1 1 1 0 0 
10 1 0 0 0 0 1 1 0 0 1 1 1 1 1 0 0 0 1 0 0 0 1 1 0 0 0 0 1 0 1 1 0 1 0 0 0 0 0 1 1 0 0 0 1 2 1 2 1 0 
10 1 1 0 0 0 0 1 0 0 1 0 0 1 0 0 0 0 1 0 0 0 1 1 0 0 0 1 1 0 0 1 1 1 0 1 0 0 1 1 0 0 5 1 1 1 4 1 1 1 
10 0 1 0 0 0 0 1 0 0 1 0 0 1 1 0 0 1 1 1 0 0 1 0 0 0 0 0 1 0 0 0 0 0 0 1 0 0 1 0 0 0 1 0 1 2 1 2 1 0 
10 0 1 1 0 0 0 1 1 1 1 0 0 0 1 1 2 1 0 1 1 1 1 0 0 0 1 1 1 1 0 0 0 0 1 1 1 1 1 5 0 0 1 0 0 1 1 1 0 0 
10 0 0 1 0 0 1 1 0 0 0 0 0 0 0 0 1 0 0 0 1 0 0 0 0 0 1 0 0 1 1 0 5 1 1 0 0 0 1 1 0 1 1 0 0 0 1 0 0 0 
10 0 0 1 0 0 1 5 0 0 0 0 0 0 0 0 1 0 0 0 1 0 0 0 0 0 1 1 0 0 1 1 1 1 0 0 0 0 0 1 0 1 0 0 0 0 0 0 0 0 
10 0 0 1 1 1 1 1 5 0 0 1 1 1 0 0 1 1 0 0 1 1 0 0 0 0 1 1 0 0 0 5 2 5 0 0 0 0 0 1 1 1 0 0 0 0 0 1 1 0 
10 0 0 0 1 0 0 1 1 0 0 1 0 0 0 0 0 1 1 0 0 1 1 1 1 0 0 0 0 0 0 1 1 1 0 0 0 0 0 0 1 1 0 0 0 1 1 1 0 0 
10 0 0 0 1 0 0 0 1 1 1 1 0 0 0 0 0 0 1 1 0 0 0 1 1 0 0 0 0 0 1 1 5 1 1 0 0 0 0 1 1 1 1 0 1 1 0 0 0 0 
10 0 0 0 1 1 0 0 0 1 0 0 0 0 0 0 0 0 0 1 0 0 0 0 0 0 0 0 0 1 1 0 0 0 1 0 0 0 1 1 2 5 1 1 1 5 0 0 0 0 
10 0 0 0 0 1 0 0 0 1 1 0 0 0 0 1 0 0 0 1 0 0 0 0 0 0 0 1 1 1 0 0 0 0 1 0 0 0 1 5 5 5 0 0 1 0 0 0 0 0 
10 0 0 0 0 1 0 0 0 5 2 1 1 0 1 1 0 0 0 1 1 0 0 0 0 0 0 1 0 0 1 1 1 0 1 0 0 0 0 0 0 0 0 0 1 2 1 1 1 0 
10 0 0 1 1 1 5 0 0 1 1 0 1 1 1 0 0 0 0 0 1 0 0 0 0 0 1 1 0 0 1 1 1 0 1 1 1 0 0 0 0 0 0 0 0 1 0 0 1 0 
10 0 0 1 0 5 0 1 1 1 0 0 0 1 0 0 0 0 0 0 1 1 0 0 1 1 1 0 0 0 1 1 1 0 0 1 1 1 1 1 1 0 0 0 0 1 0 0 1 1 
10 0 0 1 0 0 0 1 0 1 1 0 0 1 1 0 0 0 0 0 0 2 1 1 1 0 1 1 0 1 1 1 1 0 0 5 1 1 0 0 1 1 0 0 0 1 1 0 0 1 
10 0 0 1 0 0 0 1 0 0 1 1 0 0 1 1 1 0 0 0 0 1 0 0 0 0 0 2 0 0 1 1 1 0 0 1 1 0 0 0 0 1 1 0 0 0 1 0 0 0 
10 0 1 1 0 0 0 1 1 0 0 1 0 0 0 0 1 1 0 0 0 1 1 0 0 0 1 1 1 0 1 1 1 0 0 1 0 0 4 1 0 0 1 1 0 0 0 0 0 0 
10 1 1 0 0 0 0 0 1 0 0 1 0 0 0 0 0 1 0 0 0 0 1 1 0 0 1 0 1 0 1 1 1 5 1 1 1 0 0 2 1 0 0 1 1 0 0 0 0 0 
10 0 1 5 5 5 5 0 0 0 0 1 0 0 0 0 0 0 0 0 0 0 0 1 0 0 1 0 1 0 1 0 5 1 1 0 1 1 0 0 1 0 0 0 1 1 1 0 0 0 
10 1 1 1 1 1 5 0 0 0 0 1 1 0 0 0 0 0 0 0 0 1 1 1 0 0 1 0 1 0 0 0 1 1 0 0 0 1 1 0 1 1 0 0 0 1 1 0 0 0 
10 1 5 5 5 1 5 5 5 0 0 1 0 0 0 0 0 0 0 0 1 1 0 0 0 0 1 0 1 0 0 0 1 0 0 0 1 1 1 0 0 1 1 0 0 1 1 0 0 0 
10 1 5 1 1 1 1 1 5 0 0 1 0 0 0 0 0 0 0 1 1 0 0 0 0 1 1 0 1 1 0 0 1 0 0 0 1 0 1 1 0 0 1 0 0 0 1 0 0 0 
10 1 5 1 2 0 2 1 5 0 0 1 0 0 0 0 0 0 5 1 5 0 0 0 0 1 0 0 0 1 0 0 1 0 0 0 1 0 0 1 0 0 1 1 0 0 1 1 0 0 
10 1 5 1 0 2 2 1 5 0 0 1 1 0 0 0 0 0 1 1 1 0 0 0 0 1 0 0 0 0 0 1 1 0 0 1 1 0 0 1 0 0 0 1 1 5 1 1 1 0 
10 1 5 1 2 0 2 1 5 0 5 5 1 5 0 0 0 1 1 5 1 0 0 0 0 1 1 0 0 0 0 1 0 0 0 1 0 0 0 1 0 0 0 5 1 1 2 5 1 1 
10 1 5 1 1 1 1 1 5 0 5 1 1 5 0 0 0 1 0 0 1 0 0 0 0 0 1 1 0 0 0 1 0 0 0 5 0 0 0 1 1 0 0 0 5 1 5 0 0 1 
10 1 5 5 5 5 5 5 5 0 5 5 5 5 0 0 0 1 1 0 1 1 0 0 0 0 0 1 0 0 0 5 0 0 0 0 0 0 0 0 1 0 0 0 1 1 0 0 0 1 
10 2 5 0 0 0 0 0 0 0 0 0 0 0 0 0 0 0 1 0 0 1 0 0 0 0 0 1 1 0 0 0 0 0 0 0 0 0 0 0 5 0 0 0 1 0 0 0 0 1 
10 5 5 0 0 0 0 0 0 0 0 0 0 0 0 0 0 1 1 0 0 1 0 0 0 0 0 0 5 0 0 0 0 0 0 0 0 0 0 0 0 0 0 1 1 1 0 0 0 1 
10 4 5 1 1 1 1 1 1 1 1 1 0 0 0 0 0 1 0 0 0 1 0 0 0 0 1 1 1 1 0 0 0 0 0 0 0 0 0 0 0 0 0 1 0 1 1 0 0 1 
10 1 5 1 0 0 0 0 0 0 0 1 0 0 0 0 0 1 0 0 0 1 1 0 0 1 1 0 0 1 1 0 0 0 0 0 0 2 1 0 0 0 0 1 0 0 1 1 0 1 
10 1 5 1 0 0 0 5 5 5 5 1 1 0 0 0 0 1 0 0 0 1 0 0 0 1 0 0 0 0 1 1 0 0 0 0 0 0 1 1 1 0 0 1 0 0 0 1 0 1 
10 1 5 1 0 0 0 5 5 5 5 5 1 0 0 0 1 1 0 0 0 1 0 0 4 1 0 0 0 0 0 1 4 0 0 0 0 0 0 0 1 1 1 1 0 0 0 0 0 1 
10 1 5 1 1 1 1 2 1 4 5 5 1 1 0 1 1 0 0 0 0 2 0 0 0 0 0 0 0 0 0 0 0 0 0 0 0 0 0 0 0 0 0 0 0 0 0 0 0 1 
10 4 5 0 0 1 0 5 5 1 5 5 0 1 1 1 0 0 0 0 1 1 1 0 0 0 5 5 0 0 0 0 0 0 0 0 0 0 0 0 0 0 0 0 0 0 0 0 0 0 
10 5 5 0 0 1 0 0 5 1 5 5 0 5 1 1 1 1 1 2 1 5 1 1 1 1 1 1 1 1 1 1 1 1 1 1 1 1 1 1 1 1 1 1 1 1 1 1 1 5 
10 0 0 0 0 1 0 0 5 1 5 5 0 1 1 0 0 0 0 0 1 1 1 0 0 0 1 5 0 0 0 0 0 0 0 0 0 0 0 0 0 0 0 0 0 0 0 0 0 0 
10 0 0 0 0 1 0 0 5 5 5 0 1 1 0 0 0 0 0 0 0 1 0 0 0 1 1 0 0 0 0 0 0 0 0 0 0 0 0 0 0 0 0 0 0 5 5 5 5 0 
10 0 0 1 1 1 0 0 5 5 5 0 1 0 0 0 0 0 0 0 0 1 0 0 1 1 0 0 0 0 0 0 0 0 0 0 0 0 0 0 0 0 0 0 0 5 1 1 5 1 
10 0 0 1 0 0 0 0 0 0 0 0 1 1 0 0 0 0 0 0 0 1 0 1 1 1 0 0 0 0 0 0 0 0 0 0 0 0 0 0 0 1 1 1 1 5 1 1 5 1 
10 5 5 1 0 0 0 0 0 0 0 1 1 1 1 1 0 0 0 0 5 1 1 1 0 1 0 0 0 0 1 1 1 1 0 0 0 0 0 0 1 1 0 0 1 2 5 5 5 1 
10 1 1 1 0 0 0 0 0 0 1 1 0 0 0 1 0 0 0 0 5 1 1 0 0 1 1 0 0 1 1 0 0 1 1 0 0 0 0 0 1 0 0 0 0 1 1 0 1 1 
10 2 5 5 5 5 0 0 5 1 1 0 0 0 0 1 1 1 0 0 5 1 0 0 0 0 1 1 1 1 0 0 0 0 1 1 0 0 0 1 1 0 0 0 0 0 1 1 1 0 
10 5 5 5 2 1 0 0 5 5 5 0 0 0 0 0 0 1 1 0 0 1 0 0 0 0 0 1 1 0 0 0 0 0 0 1 1 0 0 1 0 0 5 5 5 5 1 1 5 0 
10 0 0 5 1 1 1 0 0 0 0 0 0 0 0 0 0 0 0 0 0 1 0 0 0 0 0 1 0 0 0 0 0 0 0 0 1 1 1 1 0 0 5 1 1 1 5 1 5 0 
10 0 0 0 0 0 1 1 1 1 1 1 1 1 1 1 1 1 1 0 0 1 0 0 0 0 0 1 0 0 0 0 0 0 0 0 0 1 1 0 0 0 5 1 1 1 5 1 1 0 
10 0 0 0 0 0 0 1 0 0 0 0 0 0 0 0 0 0 1 1 2 1 0 0 5 1 1 2 1 1 1 1 5 0 0 0 0 0 1 0 1 1 5 1 1 1 5 0 2 0 
10 0 0 0 0 0 1 1 1 1 1 1 1 1 1 1 1 1 1 0 0 1 0 0 0 1 0 5 0 0 0 1 1 0 0 0 0 0 1 1 1 1 5 5 5 5 5 0 1 1 
10 4 2 2 2 2 1 0 0 0 0 0 0 0 0 0 0 0 0 0 0 5 0 0 0 1 0 0 0 0 0 0 1 0 0 0 0 0 0 0 0 0 0 0 0 0 0 0 0 4 
35
31 2 1 245 1 1 247 1 1 445 1 1 447 1 1 516 1 1 832 2 2 1140 2 1 1310 2 2 1345 1 3 1621 1 1 1727 1 3 1939 2 3 2404 2 3 2406 2 3 2505 3 3 2506 1 3 2604 2 3 2606 1 3 2646 1 2 2901 1 1 3237 2 1 3507 2 3 3521 1 2 3719 1 2 4245 1 1 4401 1 3 4504 1 1 4820 1 1 4827 2 3 4848 2 3 5002 3 3 5003 3 3 5004 3 3 5005 3 3 