26 25 70 
10 0 0 3 0 0 0 0 0 0 1 1 0 0 0 0 0 0 0 5 5 5 0 0 0 
10 0 0 1 0 0 0 0 0 1 1 0 0 0 0 0 0 0 0 5 2 5 0 0 0 
10 0 0 1 0 0 0 0 1 1 0 0 0 0 0 0 0 0 1 1 1 5 0 0 0 
10 0 0 1 0 0 0 1 1 0 0 0 0 0 0 0 0 1 1 5 5 5 0 0 0 
10 0 0 1 0 0 1 1 1 5 5 5 0 0 0 0 1 1 0 0 0 0 0 0 0 
10 0 0 1 1 1 1 5 1 1 2 5 0 0 0 1 1 0 0 0 0 0 0 0 0 
10 0 0 1 0 1 0 5 5 5 1 1 1 1 1 1 0 0 0 0 0 0 0 0 0 
10 0 0 1 1 1 0 0 0 0 0 0 0 0 0 0 0 0 0 0 0 0 0 0 0 
10 0 0 1 1 0 0 0 0 0 0 0 0 0 0 0 0 0 0 0 0 0 0 0 0 
10 0 1 1 1 1 0 0 0 0 0 0 0 0 0 0 0 0 0 0 0 0 0 0 0 
10 0 1 1 1 1 1 1 1 1 1 1 1 1 1 1 1 1 1 2 1 1 1 5 4 
10 0 1 1 1 0 0 0 0 0 0 0 0 0 0 0 0 0 0 0 0 0 0 0 0 
10 0 2 0 2 0 0 0 0 0 0 0 0 0 1 0 0 0 0 0 0 0 0 0 0 
10 0 0 0 1 1 1 1 0 0 0 0 0 0 1 0 0 0 0 0 0 0 0 0 0 
10 0 0 1 1 1 0 1 1 1 1 0 0 0 1 0 0 0 0 0 1 1 0 0 0 
10 0 0 1 1 1 1 0 0 0 1 1 0 0 1 0 0 0 0 1 1 0 0 0 0 
10 0 0 0 0 1 0 0 0 0 0 1 1 0 1 5 5 0 1 1 0 0 0 0 0 
10 0 0 0 1 1 0 0 0 0 0 0 1 1 1 1 5 0 1 0 0 0 0 0 0 
10 0 0 1 1 1 1 0 0 0 0 0 1 0 0 1 1 1 2 1 1 1 0 0 0 
10 0 0 0 1 1 0 0 0 0 0 1 1 0 0 0 1 1 0 0 0 1 1 1 0 
10 0 0 0 1 1 0 0 0 0 1 1 0 0 0 0 0 1 0 0 0 0 0 1 1 
10 0 0 0 1 0 4 0 0 1 1 0 0 0 0 0 0 1 1 1 1 0 0 0 0 
10 0 0 0 1 0 2 1 0 1 0 0 0 0 0 1 1 2 0 0 1 5 0 0 0 
10 0 0 0 1 0 2 1 0 1 0 0 0 0 0 0 0 0 0 5 1 1 1 1 1 
10 0 0 0 1 0 1 1 0 0 0 0 1 1 1 1 1 1 1 0 5 5 0 0 2 
10 0 0 0 2 1 1 1 1 0 0 1 0 0 0 0 0 0 0 0 0 0 0 0 4 
11
120 1 1 510 2 2 1019 2 2 1202 3 1 1204 1 3 1818 1 1 2206 1 3 2217 1 1 2306 3 3 2424 2 3 2504 2 2 